parle	parler
articles	article
document	article
documents	article
contenir	parler
contienne	parler
contient	parler
contiennent	parler
fait référence à	parler
font référence à	parler
concernant	parler
parlant	parler
contenant	parler
parlent	parler
concerne	parler
concernent	parler
mots	mot
mentionner	parler
mentionne	parler
mentionnent	parler
mentionnant	parler
janvier	01
février	02
mars	03
avril	04
mai	05
juin	06
juillet	07
août	08
septembre	09
octobre	10
novembre	11
décembre	12
paru	dater
paraître	dater 
dater	dater
datant  dater
publier	dater
avant	avant
après	apres
auteur	auteur
entre	entre
événement   evénement
cote pôle    du côté des pôles
numéro  numero
compter nombre
associer    parler
contact auteur